NO ./texture/NO_image.png
SO ./texture/SO_image.png
WE ./texture/WE_image.png
EA ./texture/EA_image.png

F 184,228,248
C 170,131,92


111111111111111111111111111111111
110000000000000000000000000000011
110000000000000000000000000001111
110000000000E00000000000000111111
110000000000000000000000011111111
110000000000000000000001111111111
110000000000000000000111111111111
110000000000000000011111111111111
110000000000000001111111111111111
110000000000000111111111111111111
110000000000011111111111111111111
110000000001111111111111111111111
110000000111111111111111111111111
110000011111111111111111111111111
110001111111111111111111111111111
110111111111111111111111111111111
111111111111111111111111111111111