NO ./texture/NO_image.png
SO ./texture/SO_image.png
WE ./texture/WE_image.png
EA ./texture/EA_image.png

F 184,228,248
C 170,131,92

        111111111111111111111111111111111111111111111
        100000000011000000000000100000000000000000001
        1011000001110000N0000000100000000000000000001
        100100000000000000000000100000000000000000001
11111111101100000000000000000000100000000000000000001
10000000000000000000011111111111111111111111110000001
11110111111111011100000010001000000001111111110000001
11110111111111011100000000001000010001110001110000001
11000000110101011100000010001000000000000000000000001
10000000000000001100000010001000000001110001110000001
10000000000000001100000010001000000001111111110000001
11000001110101011111011110001111111111111111111111111
10000000000000000000011111111111111111111111110000001
11110111111111011100000010001000000001111111110000001
11110111111111011100000000001000010001110001110000001
11000000110101011100000010000000000000000000000000001
10000000000000001100000010001000000001110001110000001
10000000000000001100000010001000000001111111110000001
11000001110101011111011110001111111111111111111111111
1111111111111111111111111111111
